##########@###
..............
########.####.
########.####.
########$#####
